abuela - бабушка
buscar - искать
encontrar - находить
quires - любить
Quires a tus padres - you love your parents
Ver mucho - часто видеть
las cucharas - spoon
los tenedores - forks
cuchillo - knife

zapatillas deportivas - спортивные кросовки
reloj - часы
bombones - конфеты
prestar el dinero - одалжывать
enviar - отправлять
paquete - package
enseñar - показывать, обучать
llegar - прибывать
la via - путь
llega a la via 40 in Barcelona
horario de taquilla - рассписание кассы
fecha de salida - дата отправления
abre / sierra

Indefenido

En Casa:
p. 83 37.2-37.4
выучить текст и уметь покупать билеты

pues - then 

lunes
martes
miercoles
jueves - Thursday
viernes
sabado
domingo

la vuelta - число (дата)
