intérprete - translator
la experiencia - experience
asustad@ - scared
como a distancia - remote (work)
cometer errores - make mistakes
cada - every
esto - this
saber - to know
la carrera - карьера
pensar - think
ella esta cansada - устала
dever - to owe, must
aburido - boring
el país - county
ciudad - city
pueblo - town, village
barrio - neighborhood
llevar - take with you / to carry
yo quiero llevarte a la cama - I want to take you to the bed.
me, te, le (Usted), lo/la, nos, os, les (Ustedes), los/las
a otras paises - different countries
dejar - to leave smth - оставлять
terminar - to finish
alguno - some, someone
nota - оценка
sacar
pirat - просвистеть
vengas - приходить
hacer la cama - застилать кровать
propaganda, anuncio - реклама
apunter - конспект, записи
poner la mesa
exacto - exactly
periódico - газета
la misma - 
noticia - новость
decenas - дюжина

Alguna vez - когда то
mentira - врал
tu me mientes 
subir - подниматься 
vajar - спускаться
arribo y abajo
la torre de Eiffel - 

para nada - ни за что
romper - ламать
robar - красть
castigar - 
hijo/hija - 
portarse mal - 
hermana - 
dar a luz a - 
niño - child
natal - родной
todavia no he visitado en esta ves


Participio Irregular 

tremenda - tremendous/big in amount
rabo - tail
